3
0 0 0 0 0 0 0 0 0 9 0 0 0 0 0 1 4 4 4 4
0 0 0 0 0 0 0 -2 0 9 0 0 0 0 0 0 0 0 0 0
0 0 0 0 0 0 1 1 1 9 0 0 0 0 0 0 0 0 0 0
0 0 0 0 0 0 0 0 0 9 0 0 0 0 0 0 0 0 0 -3
0 0 0 0 0 0 0 0 0 9 1 1 1 0 0 1 1 1 1 1
0 0 0 0 0 0 0 0 0 9 0 0 0 0 0 0 0 0 0 0
0 -9 0 0 0 0 0 0 0 9 0 0 0 0 0 0 0 0 0 0
1 1 1 1 1 1 1 1 1 1 1 1 1 1 1 1 1 0 0 0
0 0 0 0 0 0 0 0 0 0 0 0 0 0 0 0 0 0 0 0
0 0 0 0 0 0 0 0 0 0 0 0 0 0 0 0 0 0 0 0
0 0 0 0 0 0 0 0 0 0 0 0 0 0 0 0 0 0 0 2
0 0 0 0 1 6 6 6 1 0 1 5 5 5 1 0 0 0 2 2
0 0 0 0 1 1 1 1 1 0 1 1 1 1 1 0 0 0 1 1
7 0 8 0 0 0 0 0 0 0 0 0 0 0 0 0 0 1 1 1
1 1 1 1 1 5 5 5 1 1 1 6 6 6 1 1 1 1 1 1